..##.....P
#.##..###.
#.###.###P
#.....###.
###.#####P